ain't=ain not
amn't=am not
aren't=are not
cann't=can not
can't=can not
cou'dn't=could not
couldn't=could not
daren't=dare not
didn't=did not
doesn't=does not
don't=do not
hadn't=had not
hasn't=has not
haven't= have not
he'd=he had
he'll=he will
he's=he is
he'sn't= he is not
I'dn't've=I do not have
I'd=I had
I'll=I will
I'm=I am
I've=I have
isn't=is not
it'sn't=it is not
it's=it is
let's=let us
I'ven't=I have not
mayn't=may not
mightn't=might not
mustn't=must not
needn't=need not
oughtn't=ought not
sha'n't=shall not
shalln't=shall not
she'd=she had
she'll=she will
she's=she is
she'sn't=she is not
shou'dn't=should not
shouldn't=should not
that's=that is
there's=there is
they'd=they had
they'll=they will
they're=they are
they've=they have
we'd=we had
we're=we are
we've=we have
weren't=were not
what'll=what will
what're=what are
what's=what is
what've=what have
where's=where is
who'd=who had
who'll=who will
who're=who are
who's=who is
who've=who have
we'ven't=we have not
whyn't=why not
wo'n't=will not
won't=will not
wou'dn't=would not
wouldn't=would not
you'd=you had
you'll=you will
you're=you are
you've=you have
(y)=thumbs_up
<3=love