aak=asleep_at_keyboard
abt=about
abt2=about to
acc=accompany
acdnt=accident
ack=acknowledge
acpt=accept
add=address
admin=administrator
aeap=as_early_as_possible
afaic=as_far_as_I'm_Concerned
afaics=as_far_as_I_can_see
afaict=as_far_as_I_can_tell
afaik=as_far_as_I_know
afair=as_far_as_I_remember
afaiu=as_far_as_I_understand
afap=as_far_as_possible
afc=away_from_computer
afk=away_from_keyboard
ai=artificial_intelligence
aight=alright
agn=again
aka=also_known_as
alr=already
alrdy=already
alot=a lot
altho=although
amap=as_much_as_possible
app=application
arc=archive_
arg=argument
asap=as_soon_as_possible
Assg=assignment
atb=all_the_best
b=be
b2b=business_to_business
b2c=business_to_consumer
b4=before
b8=bait
bak=back
bb=baby
bb=be back
bbl=be_back_later
bbq=barbeque
bbs=be_back_soon
bbt=be_back_tomorrow
bc=be cool
bc=because
bcos=because
bcs=because
bcoz=because
bcz=because
bd=big_deal
bday=birthday
bff=best_friend_forever
bf=boyfriend
bf2=battlefield_2
bff=best_friends_forever
bffl=best_friends_for_life
bk=back
brb=be_right_back
brd=bored
brh=be_right_here
brt=be_right_there
bt=but
btw=by_the_way
chk=check
clk=click
cmon=come on
cos=because
coz=because
cr8=create
cre8=create
crit=critical hit
cu=see_you
cua=see_you_around
cul=see_you_later
cya=see_you
dc=disconnect
dc=do not care
den=then
din=did not
diy=do_it_yourself
dk=don't know
Dlt=delete
dm=direct_message
dn=down
dnc=do not compute
dnr=dinner
dnt=do not
dont=do not
don't=do not
donno=do not know
dp=display_picture
dps=damage_per_second
dts=do not think so
dunoe=do not know
dupe=duplicate
dyor=do your own research
e1=everyone
edi=already
edy=already
eg=evil_grin
ei=eat it
eip=editing in progress
enuf=enough
eod=end of day
eod=end of discussion
eol=end of lecture
eol=end of life
eom=end of message
eos=end of show
eot=end of transmission
eta=edited to add
eva=ever
evo=evolution
ez=easy
f2f=face_to_face
f2p=free_to_play
fab=fabulous
faq=frequently_asked_questions
fb=facebook
fbc=facebook_chat
ffa=free_for_all
fimh=forever_in_my_heart
fitb=fill_in_the_blank
fyi=for_your_information
g2cu=good_to_see_you
g2g=got_to_go
g2r=got_to_run
g2tu=got_to_tell_you
g4c=going_for_coffee
g9=good_night
ga=go_ahead
gac=get_a_clue
gal=get_a_life
gb=goodbye
gbtw=get_back_to_work
gbu=god_bless_you
gd=good
gf=girlfriend
gfi=go_for_it
gg=good_game
gga=good_game_all
gge1=good_game_everyone
gh=good_hand
giar=give_it_a_rest
gic=gift_in_crib
gigo=garbage_in,_garbage_out
gj=good_job
gl=good_luck
gl2u=good_luck_to_you
gla=good_luck_all
gle=good_luck_everyone
gle1=good_luck_everyone
glhf=good_luck_have_fun
glng=good_luck_next_game
gn=good_night
gonna=going to
gr8=great
gratz=congratulations
grl=girl
gs=good_shot
gs=good_split
gt=good_try
gtg=got_to_go
gud=good
h8=hate
haf=have
hav=have
hf=have fun
hl=half_life
hp=handphone
hr=here
hv=have
hw=homework
i2=I too
ib=I am back
ic=I see
idc=I do not care
idk=I do not know
idts=I do not think so
ign=I got nothing
ign=in_game_nick
ik=I know
ikr=I know, right?
ilu=I love you
im=I am
imu=I miss you
inc=incoming
isnt=is not
i'll=I will
jk=just kidding
jp=jackpot
k=ok
kk=okay, okay
ks=kill_then_steal
lol=laugh_out_loud
lotr=Lord_of_The_Rings
ltr=later
lmao=laugh_my_ass_off
m8=mate
msg=message
mu=miss you
n=and
n1=nice one
nc=nice
nfm=none for me
nfm=not for me
nfs=need_for_speed
nfs=not for sale
nfw=not for work
nfws=not for work safe
nh=nice hand
nite=night
nm=never mind
nm=nothing much
nmh=not much here
noe=know
np=no problem
npc=non-playing_character
nr=nice roll
ns=nice score
ns=nice split
nsa=no strings attached
nsfw=not safe for work
nt=not
ntg=nothing
nts=note to self
nvm=never mind
nvr=never
nw=now
o4u=only for you
oic=oh_I_see
ol=office_lady
omg=oh_my_god
omw=on my way
on9=online
ootd=one of these days
ootd=outfit of the day
ooto=out of the office
op=on phone
opp=opponent
os=operating_system
otb=off_to_bed
otl=out_to_lunch
otoh=on the other hand
otp=on the phone
ott=over the top
otw=off to work
ova=over
p2p=pay to play
p2p=peer_to_peer
pbook=phonebook
pic=picture
pls=please
plz=please
pm=private_message
ppl=people
prt=party
prob=problem
psp=playstation_portable
pvp=player_versus_player
pz=peace
pza=pizza
q=queue
qc=quality_control
qotd=quote_of_the_day
r=are
r8=rate
reg=register
rec=record
realli=really
reali=really
rip=rest_in_peace
rl=real life
rly=really
rmb=remember
rt=retweet
rt=roger that
sd=sweet dreams
sis=sister
shld=should
sk8=skate
slp=sleep
soab=son_of_a_bitch
spk=speak
sq=square
srsly=seriously
sry=sorry
stfu=shut_the_fuck_up
str8=straight
sux=sucks
tbc=to_be_continued
tbd=to be determined
tbh=to be honest
tbl=text back later
tc=take care
tfs=thanks for sharing
tgif=thank_god_it's_friday
thn=then
thnx=thanks
tho=though
thu=through
thru=through
thx=thanks
tmr=tomorrow
tmrw=tomorrow
ttly=totally
ty=thank_you
tyvm=thank_you_very_much
u=you
ul=upload
ur=your
vip=very_important_person
vm=voice_mail
vn=very nice
vnh=very nice hand
vry=very
vsc=very soft chuckle
w/=with
w/o=without
w3=www
w8=wait
wb=welcome back
wc=welcome
wc=wrong channel
webo=webopedia
wep=weapon
whr=where
wif=with
wifi=Wi-fi
wk=week
wkd=weekend
wrk=work
wtf=what_the_fuck
wtg=way to go
wth=what_the_hell
wut=what
wy=way
y=why
yr=your
ystd=yesterday
ytd=yesterday