abd=Abdul
abg=abang
apr=April
ari=hari
ats=atas
awk=awak
awl=awal
ayh=ayah
aym=ayam
bang=abang
bdh=bodoh
bg=bagi
bgn=bangun
bhd=berhad
bhs=bahasa
bil=bilangan
bj=baju
bk=buku
bkn=bukan
bkt=Bukit
bl=bila
bld=Belanda
blh=boleh
blj=belajar
blk=bilik
blm=belum
bln=bulan
bpk=bapak
brt=berat
btg=batang
byk=banyak
cam=macam
cik=encik
cite=cerita
ckp=cakap
dah=sudah
ddk=duduk
dgn=dengan
dgr=dengar
dh=sudah
dik=adik
dis=Disember 
dkt=dekat
dl=dulu
dlm=dalam
dpn=depan
dpt=dapat
dr=doktor
drpd=daripada
dtg=datang
dulu=dahulu
en=Encik
feb=Februari
hj=Haji
hjh=Hajah
hlm=halaman
hosp=Hospital
hr=hari
ing=Inggeris
inst=Institut
jan=Januari
jap=sekejap
jbt=jabatan
jg=juga
jkt=Jakarta
jln=jalan
jpa=jumpa
julai=Julai
jun=Jun
jw=Jawa
jwt=jawatan
kak=kakak
kapt=Kapten
kat=dekat
kau=engkau
kejap=sekejap
ket=ketua
kli=kali
kmdr=komander
knp=kenapa
kol=Kolonel
komp=kompleks
kondo=kondominium
kpd=kepada
kpg=kampung
kpl=kapal
krg=kurang
krn=kerana
ksh=kasih
ku=aku
kump=kumpulan
kut=takut
kwn=kawan
lbh=lebih
lpr=lapar
lps=lepas
lrg=lorong
lwn=lawan
lwt=lewat
lyn=layan
mac=Mac
mak=emak
mcm=macam
mei=Mei
mkn=makan
mlm=malam
mls=malas
mmg=memang
mn=mana
mohd=mohammad
mrk=merek
msh=masih
msk=masak
nek=nenek
ni=ini
nk=nak
no=nombor
nov=November
nti=nanti
og=Ogos
okt=Oktober
org=orang
pahal=apahal
pak=bapak
pd=pada
pdg=padang
peg=pegawai
pg=pagi
pgh=pengarah
pgw=pegawai
pk=pikul
pkl=pukul
plak=pula
plg=paling
pn=puan
prg=pergi
prof=Profesor
prt=perut
ptg=petang
pyh=payah
rmh=rumah
ruj=rujukan
samb=sambungan
sbb=sebab
sbg=sebagai
sdn=sendirian
sdr=saudara
sdri=saudari
sek=sekolah
sept=September
sg=sungai
sgt=sangat
shj=sehaja
sj=saja
sjk=sejuk
skrg=sekarang
skt=sakit
skit=sikit
slmt=selamat
smgt=semangat
smlm=semalam
spai=sampai
spt=seperti
srpn=sarapan
ssh=susah
ssn=susun
syg=sayang
sym=senyum
syp=sayap
tau=tahu
tbl=timbalan
td=tadi
tdk=tidak
tdr=tidur
tel=telefon
tgh=tengah
tgl=tinggal
tgu=tunggu
thn=tahun
tj=Tanjung
tkt=tingkat
tlg=tolong
tmn=taman
tn=tuan
tp=tapi
trg=terang
trm=terima
ttg=tentang
ttp=tetap
ttr=tentera
tuk=datuk
tv=televisyen
utk=untuk
wyg=wayang
yang=sayang
yg=yang
